"filename", "language", "CMake", "CMakeCache", "Excel", "comment", "blank", "total"
"/home/xkyin/Work/AscendTikNTT/Ascend/CMakeLists.txt", "CMake", 15, 0, 0, 1, 7, 23
"/home/xkyin/Work/AscendTikNTT/Ascend/build/CMakeCache.txt", "CMakeCache", 0, 304, 0, 0, 66, 370
"/home/xkyin/Work/AscendTikNTT/Ascend/build/CMakeFiles/3.22.1/CMakeCCompiler.cmake", "CMake", 54, 0, 0, 1, 18, 73
"/home/xkyin/Work/AscendTikNTT/Ascend/build/CMakeFiles/3.22.1/CMakeCXXCompiler.cmake", "CMake", 63, 0, 0, 1, 20, 84
"/home/xkyin/Work/AscendTikNTT/Ascend/build/CMakeFiles/3.22.1/CMakeSystem.cmake", "CMake", 10, 0, 0, 0, 6, 16
"/home/xkyin/Work/AscendTikNTT/Ascend/build/CMakeFiles/CMakeDirectoryInformation.cmake", "CMake", 7, 0, 0, 5, 5, 17
"/home/xkyin/Work/AscendTikNTT/Ascend/build/CMakeFiles/Makefile.cmake", "CMake", 36, 0, 0, 7, 6, 49
"/home/xkyin/Work/AscendTikNTT/Ascend/build/CMakeFiles/baseline_cpu.dir/DependInfo.cmake", "CMake", 9, 0, 0, 5, 6, 20
"/home/xkyin/Work/AscendTikNTT/Ascend/build/CMakeFiles/baseline_cpu.dir/cmake_clean.cmake", "CMake", 9, 0, 0, 1, 2, 12
"/home/xkyin/Work/AscendTikNTT/Ascend/build/CMakeFiles/four-step.dir/DependInfo.cmake", "CMake", 9, 0, 0, 5, 6, 20
"/home/xkyin/Work/AscendTikNTT/Ascend/build/CMakeFiles/four-step.dir/cmake_clean.cmake", "CMake", 9, 0, 0, 1, 2, 12
"/home/xkyin/Work/AscendTikNTT/Ascend/build/CMakeFiles/main.dir/DependInfo.cmake", "CMake", 10, 0, 0, 5, 6, 21
"/home/xkyin/Work/AscendTikNTT/Ascend/build/CMakeFiles/main.dir/cmake_clean.cmake", "CMake", 11, 0, 0, 1, 2, 14
"/home/xkyin/Work/AscendTikNTT/Ascend/build/cmake_install.cmake", "CMake", 39, 0, 0, 7, 9, 55
"/home/xkyin/Work/AscendTikNTT/Cuda/CMakeLists.txt", "CMake", 33, 0, 0, 8, 11, 52
"/home/xkyin/Work/AscendTikNTT/Cuda/benchmark/CMakeLists.txt", "CMake", 23, 0, 0, 0, 10, 33
"/home/xkyin/Work/AscendTikNTT/Cuda/build/CMakeCache.txt", "CMakeCache", 0, 375, 0, 0, 86, 461
"/home/xkyin/Work/AscendTikNTT/Cuda/build/CMakeFiles/3.16.3/CMakeASMCompiler.cmake", "CMake", 14, 0, 0, 0, 5, 19
"/home/xkyin/Work/AscendTikNTT/Cuda/build/CMakeFiles/3.16.3/CMakeCCompiler.cmake", "CMake", 59, 0, 0, 1, 17, 77
"/home/xkyin/Work/AscendTikNTT/Cuda/build/CMakeFiles/3.16.3/CMakeCUDACompiler.cmake", "CMake", 25, 0, 0, 0, 8, 33
"/home/xkyin/Work/AscendTikNTT/Cuda/build/CMakeFiles/3.16.3/CMakeCXXCompiler.cmake", "CMake", 69, 0, 0, 1, 19, 89
"/home/xkyin/Work/AscendTikNTT/Cuda/build/CMakeFiles/3.16.3/CMakeSystem.cmake", "CMake", 10, 0, 0, 0, 6, 16
"/home/xkyin/Work/AscendTikNTT/Cuda/build/CMakeFiles/CMakeDirectoryInformation.cmake", "CMake", 7, 0, 0, 5, 5, 17
"/home/xkyin/Work/AscendTikNTT/Cuda/build/CMakeFiles/Makefile.cmake", "CMake", 164, 0, 0, 7, 6, 177
"/home/xkyin/Work/AscendTikNTT/Cuda/build/benchmark/CMakeFiles/CMakeDirectoryInformation.cmake", "CMake", 7, 0, 0, 5, 5, 17
"/home/xkyin/Work/AscendTikNTT/Cuda/build/benchmark/CMakeFiles/combine.dir/DependInfo.cmake", "CMake", 18, 0, 0, 5, 4, 27
"/home/xkyin/Work/AscendTikNTT/Cuda/build/benchmark/CMakeFiles/combine.dir/cmake_clean.cmake", "CMake", 9, 0, 0, 1, 2, 12
"/home/xkyin/Work/AscendTikNTT/Cuda/build/benchmark/CMakeFiles/merge_time.dir/DependInfo.cmake", "CMake", 16, 0, 0, 5, 4, 25
"/home/xkyin/Work/AscendTikNTT/Cuda/build/benchmark/CMakeFiles/merge_time.dir/cmake_clean.cmake", "CMake", 9, 0, 0, 1, 2, 12
"/home/xkyin/Work/AscendTikNTT/Cuda/build/benchmark/CMakeFiles/tensor_0_time.dir/DependInfo.cmake", "CMake", 16, 0, 0, 5, 4, 25
"/home/xkyin/Work/AscendTikNTT/Cuda/build/benchmark/CMakeFiles/tensor_0_time.dir/cmake_clean.cmake", "CMake", 9, 0, 0, 1, 2, 12
"/home/xkyin/Work/AscendTikNTT/Cuda/build/benchmark/CMakeFiles/tensor_1_time.dir/DependInfo.cmake", "CMake", 16, 0, 0, 5, 4, 25
"/home/xkyin/Work/AscendTikNTT/Cuda/build/benchmark/CMakeFiles/tensor_1_time.dir/cmake_clean.cmake", "CMake", 9, 0, 0, 1, 2, 12
"/home/xkyin/Work/AscendTikNTT/Cuda/build/benchmark/CMakeFiles/tensor_2_time.dir/DependInfo.cmake", "CMake", 16, 0, 0, 5, 4, 25
"/home/xkyin/Work/AscendTikNTT/Cuda/build/benchmark/CMakeFiles/tensor_2_time.dir/cmake_clean.cmake", "CMake", 9, 0, 0, 1, 2, 12
"/home/xkyin/Work/AscendTikNTT/Cuda/build/benchmark/CMakeFiles/tensor_3_time.dir/DependInfo.cmake", "CMake", 16, 0, 0, 5, 4, 25
"/home/xkyin/Work/AscendTikNTT/Cuda/build/benchmark/CMakeFiles/tensor_3_time.dir/cmake_clean.cmake", "CMake", 9, 0, 0, 1, 2, 12
"/home/xkyin/Work/AscendTikNTT/Cuda/build/benchmark/CMakeFiles/tensor_4_time.dir/DependInfo.cmake", "CMake", 16, 0, 0, 5, 4, 25
"/home/xkyin/Work/AscendTikNTT/Cuda/build/benchmark/CMakeFiles/tensor_4_time.dir/cmake_clean.cmake", "CMake", 9, 0, 0, 1, 2, 12
"/home/xkyin/Work/AscendTikNTT/Cuda/build/benchmark/CMakeFiles/tensor_5_time.dir/DependInfo.cmake", "CMake", 16, 0, 0, 5, 4, 25
"/home/xkyin/Work/AscendTikNTT/Cuda/build/benchmark/CMakeFiles/tensor_5_time.dir/cmake_clean.cmake", "CMake", 9, 0, 0, 1, 2, 12
"/home/xkyin/Work/AscendTikNTT/Cuda/build/benchmark/CMakeFiles/tensor_6_time.dir/DependInfo.cmake", "CMake", 16, 0, 0, 5, 4, 25
"/home/xkyin/Work/AscendTikNTT/Cuda/build/benchmark/CMakeFiles/tensor_6_time.dir/cmake_clean.cmake", "CMake", 9, 0, 0, 1, 2, 12
"/home/xkyin/Work/AscendTikNTT/Cuda/build/benchmark/CMakeFiles/tensor_7_time.dir/DependInfo.cmake", "CMake", 16, 0, 0, 5, 4, 25
"/home/xkyin/Work/AscendTikNTT/Cuda/build/benchmark/CMakeFiles/tensor_7_time.dir/cmake_clean.cmake", "CMake", 9, 0, 0, 1, 2, 12
"/home/xkyin/Work/AscendTikNTT/Cuda/build/benchmark/CMakeFiles/tensor_8_time.dir/DependInfo.cmake", "CMake", 16, 0, 0, 5, 4, 25
"/home/xkyin/Work/AscendTikNTT/Cuda/build/benchmark/CMakeFiles/tensor_8_time.dir/cmake_clean.cmake", "CMake", 9, 0, 0, 1, 2, 12
"/home/xkyin/Work/AscendTikNTT/Cuda/build/benchmark/cmake_install.cmake", "CMake", 27, 0, 0, 6, 7, 40
"/home/xkyin/Work/AscendTikNTT/Cuda/build/cmake_install.cmake", "CMake", 41, 0, 0, 7, 10, 58
"/home/xkyin/Work/AscendTikNTT/Cuda/build/example/CMakeFiles/CMakeDirectoryInformation.cmake", "CMake", 7, 0, 0, 5, 5, 17
"/home/xkyin/Work/AscendTikNTT/Cuda/build/example/CMakeFiles/merge_example.dir/DependInfo.cmake", "CMake", 16, 0, 0, 5, 4, 25
"/home/xkyin/Work/AscendTikNTT/Cuda/build/example/CMakeFiles/merge_example.dir/cmake_clean.cmake", "CMake", 9, 0, 0, 1, 2, 12
"/home/xkyin/Work/AscendTikNTT/Cuda/build/example/CMakeFiles/merge_ntt_cpu_example.dir/DependInfo.cmake", "CMake", 16, 0, 0, 5, 4, 25
"/home/xkyin/Work/AscendTikNTT/Cuda/build/example/CMakeFiles/merge_ntt_cpu_example.dir/cmake_clean.cmake", "CMake", 9, 0, 0, 1, 2, 12
"/home/xkyin/Work/AscendTikNTT/Cuda/build/example/CMakeFiles/tensor_7_example.dir/DependInfo.cmake", "CMake", 16, 0, 0, 5, 4, 25
"/home/xkyin/Work/AscendTikNTT/Cuda/build/example/CMakeFiles/tensor_7_example.dir/cmake_clean.cmake", "CMake", 9, 0, 0, 1, 2, 12
"/home/xkyin/Work/AscendTikNTT/Cuda/build/example/cmake_install.cmake", "CMake", 27, 0, 0, 6, 7, 40
"/home/xkyin/Work/AscendTikNTT/Cuda/build/source/CMakeFiles/CMakeDirectoryInformation.cmake", "CMake", 7, 0, 0, 5, 5, 17
"/home/xkyin/Work/AscendTikNTT/Cuda/build/source/cmake_install.cmake", "CMake", 32, 0, 0, 7, 9, 48
"/home/xkyin/Work/AscendTikNTT/Cuda/build/source/common/CMakeFiles/CMakeDirectoryInformation.cmake", "CMake", 7, 0, 0, 5, 5, 17
"/home/xkyin/Work/AscendTikNTT/Cuda/build/source/common/cmake_install.cmake", "CMake", 31, 0, 0, 7, 9, 47
"/home/xkyin/Work/AscendTikNTT/Cuda/build/source/common/include/CMakeFiles/CMakeDirectoryInformation.cmake", "CMake", 7, 0, 0, 5, 5, 17
"/home/xkyin/Work/AscendTikNTT/Cuda/build/source/common/include/cmake_install.cmake", "CMake", 27, 0, 0, 6, 7, 40
"/home/xkyin/Work/AscendTikNTT/Cuda/build/source/common/lib/CMakeFiles/CMakeDirectoryInformation.cmake", "CMake", 7, 0, 0, 5, 5, 17
"/home/xkyin/Work/AscendTikNTT/Cuda/build/source/common/lib/CMakeFiles/common.dir/DependInfo.cmake", "CMake", 14, 0, 0, 5, 4, 23
"/home/xkyin/Work/AscendTikNTT/Cuda/build/source/common/lib/CMakeFiles/common.dir/cmake_clean.cmake", "CMake", 9, 0, 0, 1, 2, 12
"/home/xkyin/Work/AscendTikNTT/Cuda/build/source/common/lib/CMakeFiles/common.dir/cmake_clean_target.cmake", "CMake", 3, 0, 0, 0, 1, 4
"/home/xkyin/Work/AscendTikNTT/Cuda/build/source/common/lib/cmake_install.cmake", "CMake", 27, 0, 0, 6, 7, 40
"/home/xkyin/Work/AscendTikNTT/Cuda/build/source/merge_ntt/CMakeFiles/CMakeDirectoryInformation.cmake", "CMake", 7, 0, 0, 5, 5, 17
"/home/xkyin/Work/AscendTikNTT/Cuda/build/source/merge_ntt/cmake_install.cmake", "CMake", 31, 0, 0, 7, 9, 47
"/home/xkyin/Work/AscendTikNTT/Cuda/build/source/merge_ntt/include/CMakeFiles/CMakeDirectoryInformation.cmake", "CMake", 7, 0, 0, 5, 5, 17
"/home/xkyin/Work/AscendTikNTT/Cuda/build/source/merge_ntt/include/cmake_install.cmake", "CMake", 27, 0, 0, 6, 7, 40
"/home/xkyin/Work/AscendTikNTT/Cuda/build/source/merge_ntt/lib/CMakeFiles/CMakeDirectoryInformation.cmake", "CMake", 7, 0, 0, 5, 5, 17
"/home/xkyin/Work/AscendTikNTT/Cuda/build/source/merge_ntt/lib/CMakeFiles/merge_ntt.dir/DependInfo.cmake", "CMake", 16, 0, 0, 5, 4, 25
"/home/xkyin/Work/AscendTikNTT/Cuda/build/source/merge_ntt/lib/CMakeFiles/merge_ntt.dir/cmake_clean.cmake", "CMake", 9, 0, 0, 1, 2, 12
"/home/xkyin/Work/AscendTikNTT/Cuda/build/source/merge_ntt/lib/CMakeFiles/merge_ntt.dir/cmake_clean_target.cmake", "CMake", 3, 0, 0, 0, 1, 4
"/home/xkyin/Work/AscendTikNTT/Cuda/build/source/merge_ntt/lib/cmake_install.cmake", "CMake", 27, 0, 0, 6, 7, 40
"/home/xkyin/Work/AscendTikNTT/Cuda/build/source/tensor_ntt/CMakeFiles/CMakeDirectoryInformation.cmake", "CMake", 7, 0, 0, 5, 5, 17
"/home/xkyin/Work/AscendTikNTT/Cuda/build/source/tensor_ntt/cmake_install.cmake", "CMake", 31, 0, 0, 7, 9, 47
"/home/xkyin/Work/AscendTikNTT/Cuda/build/source/tensor_ntt/include/CMakeFiles/CMakeDirectoryInformation.cmake", "CMake", 7, 0, 0, 5, 5, 17
"/home/xkyin/Work/AscendTikNTT/Cuda/build/source/tensor_ntt/include/cmake_install.cmake", "CMake", 27, 0, 0, 6, 7, 40
"/home/xkyin/Work/AscendTikNTT/Cuda/build/source/tensor_ntt/lib/CMakeFiles/CMakeDirectoryInformation.cmake", "CMake", 7, 0, 0, 5, 5, 17
"/home/xkyin/Work/AscendTikNTT/Cuda/build/source/tensor_ntt/lib/CMakeFiles/tensor_ntt.dir/DependInfo.cmake", "CMake", 23, 0, 0, 5, 4, 32
"/home/xkyin/Work/AscendTikNTT/Cuda/build/source/tensor_ntt/lib/CMakeFiles/tensor_ntt.dir/cmake_clean.cmake", "CMake", 16, 0, 0, 1, 2, 19
"/home/xkyin/Work/AscendTikNTT/Cuda/build/source/tensor_ntt/lib/CMakeFiles/tensor_ntt.dir/cmake_clean_target.cmake", "CMake", 3, 0, 0, 0, 1, 4
"/home/xkyin/Work/AscendTikNTT/Cuda/build/source/tensor_ntt/lib/cmake_install.cmake", "CMake", 27, 0, 0, 6, 7, 40
"/home/xkyin/Work/AscendTikNTT/Cuda/data/combine0time.xlsx", "Excel", 0, 0, 43, 0, 0, 43
"/home/xkyin/Work/AscendTikNTT/Cuda/data/mergeTime.xlsx", "Excel", 0, 0, 40, 0, 1, 41
"/home/xkyin/Work/AscendTikNTT/Cuda/data/tensor0time.xlsx", "Excel", 0, 0, 46, 0, 0, 46
"/home/xkyin/Work/AscendTikNTT/Cuda/data/tensor1time.xlsx", "Excel", 0, 0, 47, 0, 0, 47
"/home/xkyin/Work/AscendTikNTT/Cuda/data/tensor2time.xlsx", "Excel", 0, 0, 45, 0, 0, 45
"/home/xkyin/Work/AscendTikNTT/Cuda/data/tensor3time.xlsx", "Excel", 0, 0, 38, 0, 1, 39
"/home/xkyin/Work/AscendTikNTT/Cuda/data/tensor4time.xlsx", "Excel", 0, 0, 50, 0, 0, 50
"/home/xkyin/Work/AscendTikNTT/Cuda/data/tensor5time.xlsx", "Excel", 0, 0, 51, 0, 1, 52
"/home/xkyin/Work/AscendTikNTT/Cuda/data/tensor6time.xlsx", "Excel", 0, 0, 50, 0, 0, 50
"/home/xkyin/Work/AscendTikNTT/Cuda/data/tensor7time.xlsx", "Excel", 0, 0, 44, 0, 0, 44
"/home/xkyin/Work/AscendTikNTT/Cuda/data/tensor8time.xlsx", "Excel", 0, 0, 50, 0, 0, 50
"/home/xkyin/Work/AscendTikNTT/Cuda/example/CMakeLists.txt", "CMake", 8, 0, 0, 20, 13, 41
"/home/xkyin/Work/AscendTikNTT/Cuda/source/CMakeLists.txt", "CMake", 3, 0, 0, 0, 0, 3
"/home/xkyin/Work/AscendTikNTT/Cuda/source/common/CMakeLists.txt", "CMake", 2, 0, 0, 0, 0, 2
"/home/xkyin/Work/AscendTikNTT/Cuda/source/common/include/CMakeLists.txt", "CMake", 5, 0, 0, 0, 2, 7
"/home/xkyin/Work/AscendTikNTT/Cuda/source/common/lib/CMakeLists.txt", "CMake", 8, 0, 0, 0, 4, 12
"/home/xkyin/Work/AscendTikNTT/Cuda/source/merge_ntt/CMakeLists.txt", "CMake", 2, 0, 0, 0, 0, 2
"/home/xkyin/Work/AscendTikNTT/Cuda/source/merge_ntt/include/CMakeLists.txt", "CMake", 4, 0, 0, 0, 3, 7
"/home/xkyin/Work/AscendTikNTT/Cuda/source/merge_ntt/lib/CMakeLists.txt", "CMake", 9, 0, 0, 0, 5, 14
"/home/xkyin/Work/AscendTikNTT/Cuda/source/tensor_ntt/CMakeLists.txt", "CMake", 2, 0, 0, 0, 0, 2
"/home/xkyin/Work/AscendTikNTT/Cuda/source/tensor_ntt/include/CMakeLists.txt", "CMake", 3, 0, 0, 0, 3, 6
"/home/xkyin/Work/AscendTikNTT/Cuda/source/tensor_ntt/lib/CMakeLists.txt", "CMake", 16, 0, 0, 0, 5, 21
"Total", "-", 1661, 679, 504, 327, 639, 3810